d0mm000mmm0000m
00mm0mmmmmm0m0m
m00000000000m0m
m0mm0mm0mm0m00m
m00mm0m00mmm00m
mm0m0mm0mm000mm
000mmm00000m0mm
0m000mm0m0mm00m
0mm0m000m000mmm
m0m00mmmm00000m
m000mm0m00mm00m
mmm0000m0mm00mm
0m000000mmm0mmm
m00mm0mm0mm0mmm
m0000000000000F